20 20
11111111111111111111
15144414441544441451
14141444141111144411
14141111141444141411
14141444441114141441
14141411111514141141
14141444441414444141
14141114144411114141
14141415141444414141
14444411141111414141
11111415141444444141
14444444111111114141
14111114444444414441
14144411111111444111
14141414444441414441
14141414111141411141
14141414444144414441
14141411114141414111
14441444444141414451
11111111111111111111