20 20
11111111111111111111
15444144454444444451
14141141111111111411
14144144114444444411
14114441111114111141
14111414444444111141
14144444111411444441
15111114444444411141
14144444114111144441
14141141144114441141
14144144441111141441
14114441111444441151
14111141444411144441
14144444411444441411
14111111444411111441
14444444411444444411
14111111444411141441
14144444411444441141
14511111544411144451
11111111111111111111