20 20
11111111111111111111
14414441414444144141
14114111414111114141
14444414414441444141
11111444111141411141
14444414444441444441
14111444111144411141
14414414144114111441
11114144114144411411
14444111144111411441
14114144141114411141
14411111111144411141
14114444444441444441
14444111411141111411
11111444441141411441
14111141414144444411
14114144444114411141
14444444444441111141
14114144444114411441
11111111111111111111