20 20
11111111111111111111
14444444444445144441
14111111111111141141
14144144444444444141
14141111111111114141
14141444144444414141
14144411141111414141
14141415444441414141
14141414111141414141
14141411154441414141
14141414445111414141
14141414111141414141
14141414444451414141
14141411114111444141
14141544444144514141
14141111111111114141
14144444444444144141
14114111111111111141
14444154444444444441
11111111111111111111